
#######################################################################
# +-----------------------------------------------------------------+ #
# |                        Biome Inheritance                        | #
# +-----------------------------------------------------------------+ #
#######################################################################

BiomeExtends: SkyOre

ResourceInheritance: true


#######################################################################
# +-----------------------------------------------------------------+ #
# |                         Biome placement                         | #
# +-----------------------------------------------------------------+ #
#######################################################################

BiomeSize: 2

BiomeRarity: 25

BiomeColor: #FA9418

ReplaceToBiomeName: minecraft:desert

####################
# Isle biomes only #
####################

IsleInBiome: 

BiomeSizeWhenIsle: 2

BiomeRarityWhenIsle: 100

######################
# Border biomes only #
######################

BiomeIsBorder: 

NotBorderNear: 

BiomeSizeWhenBorder: 3


#######################################################################
# +-----------------------------------------------------------------+ #
# |                  Terrain height and volatility                  | #
# +-----------------------------------------------------------------+ #
#######################################################################

BiomeHeight: 0.01

BiomeVolatility: 0.1

SmoothRadius: 6

MaxAverageHeight: 0.0

MaxAverageDepth: 0.0

Volatility1: 0.5

Volatility2: -2.5

VolatilityWeight1: 0.5

VolatilityWeight2: 1.5

DisableBiomeHeight: false

CustomHeightControl: 0.0, 0.0, 0.0, 0.0, 0.0, 0.0, 0.0, 0.0, 0.0, 0.0, 0.0, 0.0, 0.0, 0.0, 0.0, 0.0, 0.0, 0.0, 0.0, 0.0, 0.0, 0.0, 0.0, 0.0, 0.0, 0.0, 0.0, 0.0, 0.0, 0.0, 0.0, 0.0, 0.0


#######################################################################
# +-----------------------------------------------------------------+ #
# |                              Rivers                             | #
# +-----------------------------------------------------------------+ #
#######################################################################

########################
# ImprovedRivers:false #
########################

RiverBiome: 

#######################
# ImprovedRivers:true #
#######################

RiverHeight: -1.0

RiverVolatility: 0.3

RiverWaterLevel: 63

RiverCustomHeightControl: 0.0, 0.0, 0.0, 0.0, 0.0, 0.0, 0.0, 0.0, 0.0, 0.0, 0.0, 0.0, 0.0, 0.0, 0.0, 0.0, 0.0, 0.0, 0.0, 0.0, 0.0, 0.0, 0.0, 0.0, 0.0, 0.0, 0.0, 0.0, 0.0, 0.0, 0.0, 0.0, 0.0


#######################################################################
# +-----------------------------------------------------------------+ #
# |                              Blocks                             | #
# +-----------------------------------------------------------------+ #
#######################################################################

StoneBlock: ENDER_STONE

SurfaceBlock: SAND

GroundBlock: SAND

SurfaceAndGroundControl: 

ReplacedBlocks: None

################################
# Water / Lava & Frozen States #
################################

UseWorldWaterLevel: true

WaterLevelMax: 63

WaterLevelMin: 0

WaterBlock: STATIONARY_WATER

IceBlock: ICE

CooledLavaBlock: STATIONARY_LAVA


#######################################################################
# +-----------------------------------------------------------------+ #
# |                       Visuals and weather                       | #
# +-----------------------------------------------------------------+ #
#######################################################################

BiomeTemperature: 0.5

BiomeWetness: 0.5

SkyColor: #7BA5FF

WaterColor: #FFFFFF

GrassColor: #FFFFFF

GrassColorIsMultiplier: true

FoliageColor: #FFFFFF

FoliageColorIsMultiplier: true


#######################################################################
# +-----------------------------------------------------------------+ #
# |                          Resource queue                         | #
# +-----------------------------------------------------------------+ #
#######################################################################

CustomStructure(EndShipN,0.125,EndShipS,0.125,EndShipE,0.125,EndShipW,0.125,EndVillagerPodA,1.0,EndVillagerPodB,1.0)
Grass(DeadBush,NotGrouped,1,100.0,SAND)
Cactus(CACTUS,4,100.0,50,100,SAND)
Boulder(STONE:5,2,2.0,50,120,SAND)
Boulder(SANDSTONE,5,2.0,50,120,SAND)
Well(SANDSTONE,STEP:1,WATER,1,1.25,50,120,SAND)
Ore(GOLD_ORE,8,18,100.0,5,50,ENDER_STONE,STONE,STAINED_CLAY)
Ore(DIAMOND_ORE,8,2,100.0,5,32,ENDER_STONE,STONE,STAINED_CLAY)
Ore(LAPIS_ORE,8,2,100.0,5,32,ENDER_STONE,STONE,STAINED_CLAY)
Ore(EMERALD_ORE,5,2,100.0,5,32,ENDER_STONE,STONE,STAINED_CLAY)

#######################################################################
# +-----------------------------------------------------------------+ #
# |                         Sapling resource                        | #
# +-----------------------------------------------------------------+ #
#######################################################################

InheritSaplingResource: false


#######################################################################
# +-----------------------------------------------------------------+ #
# |                          Custom objects                         | #
# +-----------------------------------------------------------------+ #
#######################################################################

BiomeObjects: 


#######################################################################
# +-----------------------------------------------------------------+ #
# |                            Structures                           | #
# +-----------------------------------------------------------------+ #
#######################################################################

StrongholdsEnabled: true

WoodLandMansionsEnabled: false

OceanMonumentsEnabled: false

NetherFortressesEnabled: true

VillageType: sandstone

MineshaftType: normal

MineshaftRarity: 1.0

RareBuildingType: desertPyramid


#######################################################################
# +-----------------------------------------------------------------+ #
# |                           Mob spawning                          | #
# +-----------------------------------------------------------------+ #
#######################################################################

SpawnMonsters: []

SpawnCreatures: []

SpawnWaterCreatures: []

SpawnAmbientCreatures: []

BiomeDictId: COLD, DRY, END

InheritMobsBiomeName: Sky

